Delal	Abzak
Fatma	Acar
ozde	Acarkan
Atahan	Adanir
Haci	Adiguzel
Mukerrem	Agca
Bestami	Agiragac
Aykanat	Agiroglu
sennur	Agnar
Tutkum Asl
Mugenur	Ahmet
Sevinc	Ak
Kayihan	Akarcali
Lemi	Akarcay
Cihan	Akarpinar
Rafi	Akas
Mehmetcan	Akay
Nuhaydar	Akbilmez
Emine	Akca
Servet	Akcagunay
cilem	Akcay
Recep Akdogan
Emre	Akfirat
Kerime	Akilli
Ercument	Akincilar
Sarper	Akis
Berker	Akkiray
Iclal	Akkoyun
Lemis	Akkut
Ahmet	Aklar
Ata	Akman
Ahmet	Akoguz
Ecem	Akova
Nuket	Aksan
Senem	Aksevim
Aysen	Aksoy
Pekcan	Aksoz
Bedirhan	Aksamoglu
Semina	Aktuna
Eda 	Akyildiz
Muyesser	Akyildirim
Selinti	Al
Bahar	Albas
Ilma	Aldag
Kutlu	Alibeyoglu
Nesibe	Alkan
Bugra	Alparslan
Hiba	Alpugan
Mazlum	Altan
Elif	Altas
Ahmet	Altay
Yasar Utku
Rana	Altinoklu
Fethullah	Altinoz
Burak	Altintas
Merve Altiok
Rima	Altiparmak
Elif	Altinkaya
Sirma	Altunbas
Nefse	Altunbulak
Busra	Altundal
Erna	Aluc
Hikmet	Alver
Ismail	Anik
Ilkay	Ankara
Nebahat	Ansen
Ilyas	Apul
Halim	Aral
Yasin Arap
Cansev	Arat
Memet	Ardic
Deniz	Arican
Izlem	Arinc
oget	Arif
seyda	Arikan
Zeki	Armutcu
Nunazli	Arpaci
Ferdacan	Aruca
serife	Asil
Mustafa	Askin
Ilim	Aslanturk
Sevginur	Asci
Hayrunnisa	Asveren
Hanife	Ata
Sevtap	Atan
Paksoy	Ates
Ilkim	Atescan
Rubabe	Atli
Saba	Atmaca
cisem	Atok
Sabiha	Atol
Edip	Attila
Almina	Avci
Saime	Aviandi
Nehar	Avsar
Kaan	Ay
Murat	Ayanoglu
Murat	Ayaz
Ates	Ayci
Zeynep	Aydinlioglu
Kerime Yozgat
Hami	Aydogdu
Thomas	Aygen
Gunes	Aykan
Elif	Ayrim
Ugur	Aysal
Osman	Aysan
Adem	Ayvacik
Sera	Azbay
Ali	Babacan
Ruhugul	Babadostu
Alcicek	Bad
Memet	Bagci
Mercan	Bagcivan
Gokay	Bagis
Pirilti	Bahceli
ozgun	Bahtiyar
ozgen	Baka
Seung	Baki
Gulser	Bal
Yuksel	Balci
Ecren	Baldo
Muhammet	Bali
Sakip	Balioglu
Kazim	Balta
Abdullah	Baluken
Coskun	Baran
Serdar	Barbaros
Ezel	Bargan
Aysegul	Barutcuoglu
Sefa	Basar
Elif Basegmez
Balin	Bastepe
Mahperi	Bastopcu
Erol	Bastug
Atak	Batar
Safa	Batga
Gokmen	Battal
Fazi	Batuk
Bensu	Batur
Nazim Baturalp
Safa	Baydar
Demircan	Baydil
Burcin	Baykal
Dervis	Baykan
Taylan	Baykus
Abdulvahap	Bayrakoglu
Aygun	Bayram
Ayla	Baytin
Kubilay	Begic
Mustafa	Begenilmis
Berfin	Bekaroglu
Ibrahim	Belge
Jutenya	Benan
Hulki	Bent
Mustafa Berberoglu
Huner	Berk
Buse	Berker
Halime	Beydag
Didem	Bicaksiz
Mihrinaz	Bilal
Lal	Bilgec
Senay	Bilgen
Remzi	Bilgi
Armagan	Bilgic
celik	Bilgir
Kubra	Bilgit
Uluc    Binbay
Mehmet	Birgili
Doguscan	Biriz
Altan	Boy
Bengisu	Boya
Onur	Boylu
Ayseren	Boyuktas
Pekin	Boz
Aksu	Bozdag
Arkan	Bozdemir
Iltem	Boztepe
Betul	Bozyer
Ogun	Bolge
Ibrahim	Bugey
Onay	Bugdaypinari
Cankiz	Bulgan
Arzucan	Bulgur
Asiye	Burabak
Ahmet	Burak
Yaprak	Bural
Aleda	Buyuran
Can	Bulbul
Mahmut	Bulend
Saliha	Bulent
Melike	Buyukfirat
Hayriye	Buyukgungor
Sebiha	Buyukozturk
Mehmet Akcaozoglu
Mehmet	Canan
Kurtbey	Canbagi
Mustafa	Canbek
Sena	Candan
Abdullah	Caner
Mustafa	Cansu
Doktora	Canuyar
Seyit	Ceran
Selma	Ceylan
Askim	Chiklyaukova
ozgur	Choi
Tugce	Cibooglu
Seckin	Ciddi
Balkin	Cigerlioglu
Yucel	Civan
sansal	Cosan
Oguzcan	Cosandal
Mayis	Cumali
Busra	Cuce
Afra	cagan
Gonul	cagatay
Dogangun	caglar
Elif	caglayan
ozen	cakan
Dilhan	cakanel
Maral	cakici
Mahire	calim
Haci Bayram
Oltun	canga
onel	capa
Bayulken	caprak
Dilseren	carici
Elif Beyza
Elvan	catal
Esim	caylar
Sena	cekmecelioglu
Muhammed	cekmeci
Aydin	celebican
cagkan	celenlioglu
Zumra	celik
Bayar	celik
Gonulgul	celikagi
Ece	celiker
Mehmet	celikkol
Elife	cerci
Efecan	cetintas
Ridvan	cikikci
Hatice	cinar
Yansi Hilal
Omac	cingir
Erhan	ciray
suheda	cicekli
unkan	cini
Ahmet Gazi
Seher Irem
Gurbuz	civici
Zulal	colak
Ozan	comu
Hilal	conay
Ayben	corumlu
Abdulbaki	cotur
Neva	cuhadar
oznur	culhaoglu
Olgun	Dadalioglu
cagri	Dagar
ozalp	Dagbag
Husne	Dal
Aydonat	Dalkilic
Ezgin	Dalli
Refiye Dalyaprak
Esat	Danis
Ayse 	Dasdemir
Fetullah	Davutoglu
Mert 	Dayioglu
Ergun	Degirmendereli
Hulya	 Chasan
Doga	Delice
Muhammed	Deliloglu
Mirac	Demiroren
Hurel	Demiriz
Somer	Demiroglu
Aysel	Demirsatan
Mehmet	Dengizek
Alya	Denizgunu
Zeynep	Derdemez
Tubanur	Dereli
Dalay	Derya
Bedir	Destereci
Rumeysa	Devecel
Osman	Devrim
Saliha	Divarci
Samet	Dikbas
Haldun	Dincturk
Goncagul	Diri
Ziya	Dogramaci
ZehraDoger
Selim	Dokulmez
Firuze	Donder
Doruk	Doner
cisil	Donmez
Tugce	Dudu
Enver	Dur
Sanber	Durak
Birsen	Durmus
Tacmin	Durmusoglu
Karanalp	Dursun
oktem	Duymus
Elanaz	Dulgerbaki
Fidan	Dundar
Barin	Dusenkalkar
Mehmet	Duzbayir
Cem	Edes
Erem	Edibali
Volkan	Efsin
Ibrahim Alp
Gungor Erkin
cagin	Egin
Alphan	Ekercan
Lale	Ekrem
Bagis Elbasi
Mert Elicin
Ahmet Emikoglu
Akife	Erbay
Burc	Erbil
Nadire	Erbul
Huseyin Ercoskun
Aynur Ercument
Samed	Erek
Cem	Erim
Bahar	Erin
Rekin	Erkek
Huseyin Erkekli
Ibrahim	Erki
Beniz	Erkmen
Hasan Erkoc
Selman	Erkosan
Hanife Erkovan
Alper	Erkus
Elif Eroglu
Abdullah Erol
cisel	Ersin
Ilkin	Ersoz
Cantekin	Erten
Onur	Ertepinar
Ismail Eruzun
Hamid	Eryildiz
Tunca	Eryilmaz
Arslan	Erzurumlu
Neslihan Esat
Lutfiye Esen
Belin	Esendemir
Rukiye	Esgin
Islam	Eshaqzada
Batiray	Eski
Suheyl	Esvap
Yargi Ese
Elzem	Evrenos
Ilgaz	Eyipisiren
Ongar	Eyyupoglu
Faik	Ezber
Turan	Fahri
Okbay	Fatih
Latife	Fatin
Eyup Findik
Irfan Findikci
Ertug	Furuncuoglu
Berhudan	Garip
Nihan	Gazitepe
Menekse	Geben
seniz	Gebologlu
Zeynep Gecioglu
Hayri Geckin
Muazzez Gemalmaz
Kerem Gencoglu
Sadik Gezmis
Resmiye Girgin
Nergiz	Gilim
Mehmet Ginovic
Mehmetali	Girgin
Abdullah	Golba
Tilbe	Goc
Kubra	Gocmen
Kubilay	Godek
Busem	Gokceaslan
Banuhan	Gokcek
orgun	Gokhan
Melike	Goksoy
Yesim	Golmes
Nilufer	Gonay
Denizhan	Gonul
sueda	Goreke
Ersin	Gorgulu
sahabettin	Gorguner
Ayse Gorur
Nazim Goven
Meltem	Goymen
Abdulhalim	Guguk
Gulten	Guducu
Isinbike	Gulcan
Vedia	Gulcin
Fatma	Guldogus
omer	Gulebakan
Aybike	Gulec
Bektas	Gulenc
Emircan	Guleryuz
Merter	Gulkan
Sevgi Gulluce
Denktas	Gulsen
Koksal	Gultas
Hasan Gultepe
oymen	Gumussoy
Eylem	Gunduz
Melek Gunel
Argun	Guneri
Mehmet Guneyi
Yasemin Guntek
Gunan	Gural
Osman Gurdemir
Okyanus	Gurel
Mert Gures
Zeynep	Gurses
Tarik	Guven
Birgen	Guvener
Ahmet Guzel
Manolya	Guzeller
Mustafa Guzeloglu
Mehmet Hacialioglu
Ahmet Hacilar
Fazilet	Hacioglu
Kivilcim	Hadi
cisil Hafiz
Feray	Hakverdi
Busranur	Halacoglu
Selin Halicilar
Yeter	Hamamcioglu
Ramazan Hamarat
Boran	Hamidi
Tazika Hamzaoglu
Aynur 	Hanci
Ayman	Hangul
Berrak	Harman
Erk Harmankaya
Perihan	Haykir
Turhan Hirlak
Furkan	Hizarcioglu
Mustafa Hicyilmam
Muhammed Hilal
Argun	Hilmi
Fadik	Himoglu
Ahmet	Hirik
Mustafa Hopaci
Toykan	Horata
Selime	Huner
Denizcan	Ilik
Ayse Iricioglu
Mustafa Isinay
Sude	Ibrahim
Guclu	Icten
Katya	Ilgezdi
Halid	Ilhan
Nihal	Ilisu
Elif Imamoglu
Emine Imre
Tevfik	Inal
Ibrahim Incekara
Sidar	Inceoglu
Nesli	Ipcizade
Ihsan Ipekoglu
Necati	Irsoy
Zerin	Ishakoglu
Dursun Isgoren
Ahusen	Isguzar
Uzel	Kabatas
Melis Kabayuka
saziye	Kabukcu
Berguzar	Kacaranoglu
omer	Kadi
Daghan	Kadoglu
unzile	Kalfaoglu
Sezer	Kalsin
sensoy	Kalyoncu
Necati	Kamisli
sahan	Kandasoglu
Necip Kanli
Muharrem	Kanmaz
Zeynep Kantarci
cilay	Kapsiz
Suna	Karaaslanli
Ahmet Karabacak
Asya Karabag
Gul Karabiyik
Fatma Karabiyikli
Arca	Karabulut
Abdullatif	Karacabey
Tugra	Karacan
Emir	Karacay
Haluk Karacesme
Seyit Karadag
Cevza	Karadalan
Mustafa Karademir
Ilgar Karaismail
Seren	Karakan
Busra Karakaplan
Naci	Karakaya
Oguz Karakelle
Faik Karakoca
Dincol	Karalar
Ceyhun Karamollaoglu
Tayyibe	Karanisoglu
Hayriye Kararti
Gulsanem	Karasapan
Yelda	Kardas
Kuntay Karga
Ahmet Kargin
Kivanc	Kasaci
Vira	Kasemllar
orsel	Kaska
Esma Kavak
Benek	Kavas
Hale Kavasoglu
umit	Kavukcu
Ishak	Kayacan
Ibrahim	Kayahan
odul	Kayali
Ege Kayar
Mahmut Kayhan
Mimoza	Kaynamis
Cemile	Kazici
Belit	Kece
Asli Kefal
Acun	Keles
Behcet Kerem
Ayse Kerigan
Behin	Kerimov
Fatma Kesbic
Nun	Kesgin
Ahmet Keskin
Mehpare	Keteci
Muhammed Kevkir
Alaatin	Kilcadir
Hamit	Kildir
Muktedir	Kilincarslan
Onur Kina
Lokman	Kirbiyik
Mert	Kirgiz
Gulenay	Kiris
Murside	Kirkpinar
Furkan Kirmizi
Hatice Kirtas
Yasar Kirtay
Parla	Kiryayla
Gulce	Kivilcim
Yasin Kizil
Alim	Kizilboga
Iscan	Kizilca
Evren Kizilirmak
ozge Kizilkaya
Dilsad	Kiziltug
Enes	Kizmaz
Yalcin	Kilmen
Ali Kirezcik
Kaancan	Kisial
Maisam	Kisin
Mehmet Kocabas
Irazhakkina	Kocabiyik
Yigithan	Kocademir
Irem Kocak
Yusuf Kocbaba
Iptal	Kocsoy
Abdulsamet	Konakoglu
Mehmet Kondakcioglu
Ahenk	Kontaci
Hayat	Konyar
Yigit Koparan
Guner	Korkmazcan
Berfu Koskulu
Ilke	Kotan
Ali Kovanci
Fatmanur	Koytak
Ibrahim Koyunsev
Aslinaz	Kozakcioglu
Ataalp	Kocer
Macide	Kokcu
Mustafa	Koken
Aybar	Kormukcu
Sahin	Kose
Tunc	Koybasi
Ruveyda	Kuday
Gurol	Kudu
Chakan	Kukaraci
Elis	Kul
Selma	Kuloglu
Huseyin	Kumru
Acar Kundakci
Guney	Kunter
ozge Kuntman
Seval	Kurtan
Berna	Kurtulus
serif 	Kutanoglu
Melike 	Kutlay
Aycag	Kucukbey
Sadiye	Kucukkase
Ali	Kucukler
Nigar	Kulahlioglu
Gulben	Kurk
Ayse 	Kurkcu
Eralp	Kurum
Alperen	Kusku
Zehra 	Madran
Gunduz	Magden
Osman 	Maldar
Kubat	 Ravasan
Bahar 	Mammadov
Nuelif	Mardanlou
Mehmet 	Masaraci
Melis	Masir
Fatima	Matur
Karaca	Maydagil
Zafer 	Memisler
Duygun	Menguc
Havagul	Mercimekci
Arif 	Merdan
Halit 	Mert
Pertev	Metin
Selis	Mezarci
Galip	Mirzanli
Tulay 	Misoglu
Ahuse	Mohamed
Barbaros	 Ametali
Lawrence 	Morbenli
Gorkem	Morelli
Abdurahman	Morgul
Zulcenah	Mortepe
Saadetnur	Mumcu
Hasan 	Muratoglu
Sehmus	Mursal
Berkan	Musaoglu
Ersel	Muslu
Batug	Mutman
Dilsu	Munif
Erdogan	Nalbant
Bati	Nalbantoglu
Turkan	Nalcaci
Gulpinar	Namdar
Gokcin	Namli
ulker	Nayman
Eslem	Nerkis
Nazli 	Nisanci
Alkiz	Numanoglu
Nimet	Ocalan
Ismail 	Ocar
Kamer	Oduncu
Gencal	Oguz
Kursat	Oguz
Irem 	Oguzhan
Ulas 	Okan
Tunahan	Okatan
Izel	Okcu
Eliz	Okkaya
cisil	Okumus
Kerem	Onus
Keremcan	Oraloglu
Talip	Orhan
Beste	Orhon
Ismet	Orman
Mustafa 	Ozgun
Ogan	ocal
Ahmet 	ogredik
Vahide	okmen
Murtaza	olmezler
Gonen	onder
Zeynep 	onen
Gunkut	onoglu
Faruk 	oreroglu
Gunyol 	orge
Selimcan	ors
Raif	oter
Okan 	ovul
Mustafa 	oyus
Aysel	oz
Ajlan	ozakyol
Ayhan 	ozar
Ebru 	ozata
Berfin 	ozay
Muhammet	ozaydin
Arda 	ozayral
Isilay	ozbey
selale	ozbir
Oktay 	ozcan
Guniz	ozdel
Murathan	ozdil
Kadirr	ozdincer
Anil 	ozelci
Dilay 	ozer
semsi 	ozev
Ilay	ozgenc
Bedia	ozgenoglu
Kadir 	ozgezgin
Ecem	ozgul
Giray	ozgumus
Abdulsamed	ozgur
Tendu	ozgurun
Emine 	ozirk
Mehmet 	ozkol
Egehan	ozkok
Mustafa 	ozkul
Iremnur	ozmez
Fahir	ozpak
Ali 	ozpercin
Eyupcan	ozperk
Merve 	ozpolat
Muhammer	ozsoydan
Arkadas 	oztas
Gunaydin	ozteker
Zuleyha	oztemel
Mustafa 	oztunc
Okcan	ozturk
Muhammed 	ozuberk
Gamzenur	Padak
Muhammed 	Pak
Zeynep 	Pakdemirli
safak	Pakdil
sukran	Pakkan
Altay	Paksoy
Hicret	Palanko
Nusret	Palut
omer	Pamukcu
Mehmet 	Pancar
Aysu	Parlak
Cenap	Pasolar
Ata	Pazar
saban	Pehlevan
Huma	Pehlivan
Ekin 	Pehlivanli
Mehtap	Pehlivanoglu
Mehmet 	Pekdogdu
Cihad	Pektemek
senay	Piristina
umran	Pocan
Evren	Pomay
Kevser	Portakal
Ziynet	Posbiyik
Muhammed 	Poslu
Efgan	Puca
Bahar 	Purcu
Dilara 	Ramis
Tomurcuk	Rauf
Simavi	Remzi
Esma 	Revan
Utku	Rona
Nurseli	Rusan
Urcuk	Saatciler
cagatay	Sabah
Niyazi 	Sabri
cagla	Sacak
Ayse 	Sadak
Ali 	Sadiklar
Tayyip	Sadikoglu
Nesat	Sadri
Ferudun	Saf
Ayse 	Sakarya
Emre 	Sakaryali
omer 	Saltuk
Ahmet 	Samanci
Ali 	Samar
Fatma 	Sami
Arcan	Saparca
Gunnaz	Sar
Simge 	Saracgil
Nesrin 	Saraclar
Ayse 	Saray
Nuece	Sarialtun
Muhterem	Sarioglu
Esengul	Sariteke
Cansunur	Savca
Necmettin	Saydam
Melike 	Saydan
Aycicek	Saygin
Muhammet 	Sayici
Orkide	Sayil
ozge 	Sayrac
Refia	Sazak
Yasemin 	Schmitz
Mina	Sel
Servet 	Selcuk
Sevde 	Selvi
Abdullah 	Senturk
Olca	Sevcan
Nebi	Sever
Yasemin	Sevigen
Gunay	Seydaoglu
Zuleyha	Seyfi
Tunay	Seyhan
Tanju	Seymen
Muhammed 	Seytin
Mehmet 	Sirac
Kaan 	Simavli
Ayse 	Sobaci
Canel	Sofyalioglu
Rabia 	Solak
Ikbal	Songur
Esat	Soyadi
Yunus 	Soylu
Kanaat	Soyulmaz
Cengizhan	Sokel
Gencay	Soker
Gazanfer	Soylemez
Dorukhan	Sozeri
Hesna 	Sozuer
Ilknur	Sozumcetin
Firuz	Su
Hasan 	Sugoturen
Guzay	Sular
ozgun 	Suna
Ipar	Suyunu
Gural	Suhan
Naz 	Suleymanzade
Iris	Sureyya
Gulselin	Surmeli
Alper	sadi
Abbas	sahabettinoglu
Nugaye	sahin
Buraktan	sahingoz
Efe 	sakarcan
Behiye	samlioglu
Yagmur 	sarkisla
Aslican	sekercioglu
cigdem	sekeryan
Taykut	sen ozen
Fehime 	senbas
ogunc	sencan
Gurkan	sendag
Sezanur	sendiller
Seher	sengul
Nejat	senocak
Yeliz	senyurd
Ali 	serbetci
Ada	seref
Yunus 	serifoglu
Melike 	sevkin
Mehves	Tabak
Furkan  	Tabanli
Aykan	Tabir
Ahmet 	Tac
Dilara	Tacgin
Mirac 	Tahir
Kardelen	Tahmazoglu
Pinar 	Talantemur
Arel	Talas
Aysegul 	Tanbasi
Farshad	Tanis
Guzin 	Tanrikulu
Ebru 	Tarakci
Numan	Tarhan
celiker	Tarlakazan
Seven	Tas
Bala	Tasak
Koker	Tascioglu
Batughan	Tasgin
Guven	Tasli
Ecegul	Tasyurek
Beyzanur	Tatli
Kerem 	Tatlisu
Abdussamet	Tayan
Tilbe	Tayfun
Ismail	Tazegul
Ogur	Tecer
Aktan	Teker
Ahmet	Tekin
Deniz	Teksan
Umut	Tektas
Isiltan	Tekten
Erdem	Temizer
Atalay	Tenim
Ali	Tercan
Sabiha Terzi
Yakup 	Tetik
Talya	Tezmen
Tugbanur	Tiftikci
Aktac	Togay
Ahucan	Togan
Saime	Tokac
Dogcan	Tokali
Bilhan	Tokatlioglu
Muhammed	Tokdogan
sukru	Toker
Ecenur	Tokgoz
Baysal	Tolunay
Muge	Topal
Dilsah	Topalan
Saliha	Topoyan
Tarcan	Toptan
Ruya Torgutalp
Gulsen	Torol
Velit	Toygar
Perker	Tufan
Lerzan	Tugrul
Nue	Tugmen
Yasar	Tuncay
Aybuke	Turna
Muhammet	Turul
Lalezar	Turunc
Iyilem	Tudes
Istemi	Tufekci
Ilsel	Tufekcioglu
Muhammed	Turkmenoglu
Mebruke	Turkoglu
ummu	Tut
Gokbori 	Ubay
Zeynep	Ucanok
Malik	Ucar
Umut 	Ucma
Enginsu	Ugur
Mervegul	Ulas
Ugur	Ulug
Caner	Uluhan
Aysim	Ulupinar
Arife	Ulusoy
Hatice	Ulutas
Kuntay	Urganci
Berra	Urgancioglu
Zehranaz	Usanmaz
Ahuela	Usluer
Bedriye	Usta
Alp	Ustabasi
Gulumse	Usumi
Engin	Usak
Gizemnur	Uyu
Kemal	Uz
Tahsin	Uzun
Ugur	Uzundonekoglu
Arsun	Uzunirmak
ozgecan	ucler
Siddika	uctas
Imran	ulgey
Ebrar	unay
Acilay	unlu
Muzehher	unlu
Aybirgen	urkmezturk
Akif	uskent
Volkan	ustbas
ozmen	ustunel
Gulender	usenmez
Muzaffer	uzar
Mediha	Vanli
Sulhadin	Varli
Buket	Yildiz
Seirf	Yakupoglu
Sena	Yalcinkaya
Mumune	Yalcintas
Edis	Yalmac
Alagul	Yalman
Nazim	Yalova
Ekin	Yamanoglu
Ayse	Yanik
Anil	Yapar
Cavit	Yaprak
Gulsah	Yarbas
Isilti	Yardimci
Ayse	Yasa
Muhammed	Yasin
Nurullah	Yasin
Nuvit	Yavaser
Taner	Yay
Sezen	Yayla
Tuna	Yazicigil
Raif	Yazicioglu
Dilara	Yeksan
Muhammed	Yel
Busra	Yelegen
Meryem	Yeniceli
sayan	Yeniev
Aykut	Yerlikaya
Ilkyaz	Yerliyurt
Gulsen	Yerzhan
Nurettin	Yesilcimen
Ali	Yesilova
Kolcak	Yikilmazsoy
Selen	Yildirimer
Azelya	Yildizdoken
Ibrahim	Yildizoglu
Sadri	Yirmibescik
Enes 	Yolcu
Eser	Yorgun
Selcen	Yorulmaz
Alaaddin	Yondem
Jiyan	Yoruten
Buse	Yudulmaz
Ali	Yumurtaci
Yusuf	Yurteri
Yigit	Yurtsever
Ahmet	Yucekayali
Tanberk	Yukselen
Zarife  Yuruk
Ayse 	Yurukgil
Emre Mirac
Ipek Zabun
Mutesir	Zagli
Nurfer	Zaptiye
Busra Zeybek
Bernanur	Zeybekci
Nur 	Zilan
Ali Ziyade
Paker	Zorkirisci
Beyda	Zog
